1111111111
1000000011
1001000101
1010001001
1000010001
1000100001
1001000101
1010001001
1100000001
1111111111