1111111111
1111011111
1110011101
0100011100
0000001100
0000000100
0000000100