1111111111
1000101000
1010101011
1010000011
1110111111
1000001011
1011101011
1000100011
1110101011
1000001011
1111111011